WWWWWWWWWWWWW
W.....O.....W
W...........W
W...........W
W...........W
W...........W
W...........W
W...........W
W...........W
W...........W
WWWWWWWWWWWWW