WWWWWWWWWWWWW
W..O.....O..W
W...........W
WO.........OW
W...........W
W0.........0W
W...........W
WO.........OW
W...........W
W..O.....O..W
WWWWWWWWWWWWW