WWWWWWWWWWWWW
W..O..O..O..W
W...........W
WO.........OW
W...........W
WO.........OW
W...........W
WO.........OW
W...........W
W..O..O..O..W
WWWWWWWWWWWWW